11111111111111111111111111111111111111111111111111111111
1E010000100010000001010001001000100100100010100000100001
1011010100100P00110101000000011101C011000000000000000001
10100100101010100101010000000101000000C11000000000000001
10111111111111111101000000000000C00000000000000000000001
10000000000000C000010000000000000000000C00C0000000000001
11111111111111111111111100000101000000111000000000000001
10100100101010100010010000000101000100000000000000000001
10000000C00C0011111111000000000C000000000000000000000001
100000000000000C00000C0001100000000000111000011111111001
101001010010000010C0010001101110000000100000000000000001
10100100101010100010010001100101000000111000000000000001
100000000C00C0000000000001100000C00000000000000C00100001
100000000000000C0001101011110C01101C10011001100000100001
10100101001000001010010001100101000100000000000000100001
10100100101010100010010001100101000000111000000000100001
100000000C00C0000000000000000011000100000100000000100001
10000000001111111111111000000000000000111000111111111101
10100101001000001010010000000101000010000000000000100001
10100100101010100010010000000101000000000000000000100001
100000000C00C0000000001111111111C00000111000000C00100001
100000000000000C00000C0000000000000000000000000000100001
1010010100100000101001C000000101000000000000000000100001
10100100101010100010010000C00101000000100000000000100001
100000000C00C0000000000000000000C0000011100000000010C001
11111111111111111111111111111111111111111111111111111111